#x###########################################################
#  #  #           #  #                    #           #     #
#  #  ##########  #  ##########  #######  ####  #  #  #  ####
#        #  #     #  #        #     #     #     #  #     #  #
#  #######  ####  #  ####  ####  #  #  #######  #  #  #  #  #
#                       #     #  #  #  #  #     #  #  #     #
##########  #  ####  #  #  #  #######  #  #######  #######  #
#           #     #  #  #  #     #        #        #        #
#  #######  #######  ####  #  ####  ####  ##########  ####  #
#  #  #  #        #        #           #              #     #
####  #  ####  #######  #######  #  ####  #######  ##########
#     #  #  #     #  #  #  #  #  #     #        #  #        #
#  ####  #  ####  #  ####  #  #  #######  ####  ####  #  #  #
#        #  #     #     #        #        #        #  #  #  #
#  #  #  #  #######  #  #  #######  ####  #  ####  #  #######
#  #  #  #     #     #  #  #     #     #  #     #  #        #
####  #  ####  #  #######  #  ####  #  #  ################  #
#     #     #     #  #  #     #     #  #     #  #     #     #
#  ####  #######  #  #  #  ####  #  #######  #  #  #######  #
#     #  #        #     #  #     #     #                 #  #
#  ##########  #######  #  #  ####  #############  #######  #
#     #           #        #     #     #     #              #
#  ####  #  #######  ####  #  #  ####  ####  ################
#        #  #     #  #     #  #     #  #              #     #
#  ####  #######  #  #  #  #  #  ####  #  ################  #
#  #  #     #        #  #  #  #     #  #        #           #
####  #  ####  #######  ##########  ####  ####  #  ####  #  #
#           #     #  #     #        #  #     #        #  #  #
####  ####  ####  #  #  ##########  #  #  #  #  #  ##########
#        #        #  #  #              #  #  #  #  #        #
#  ####  #  #######  ####  #  #  ####  ##########  ####  ####
#  #     #        #     #  #  #  #  #                 #     #
####  #######  #######  #######  #  ####  ####  #######  ####
#     #        #     #  #  #  #     #        #              #
####  ####  #  #  ####  #  #  #  #######  #  #######  #  ####
#  #  #  #  #     #           #  #        #     #     #     #
#  #  #  #######  ####  #  ##########  #  ####  ####  #######
#        #     #        #     #     #  #  #     #           #
####  ####  #  #  ##########  #  #  ####  #######  ####  ####
#        #  #              #     #  #           #  #        #
###########################################################@#
