###############
#             #
#  #########  #
#             x
##@############
