#####x####
####   # #
## #     #
##     # #
### #### #
### # ####
#   # # ##
##  #   ##
##      ##
##@#######
