#################
##  # # ###    ##
## ## # ##### #x#
## ## # #####   #
## #  # # # #   #
##  #    # ###  #
##   # #    #   #
## #  # # # #   #
##  #    # ###  #
##   # #        #
## #  # # # #   #
##  #      ###  #
##   # #    #   #
## #    # # #   #
##  #    # ###  #
##   # #    #   #
########@########
#################
