##x##
#  ##
# # #
#   #
#@###
